35 71
11111111111111111011111111111111111
10000010000000000000000000100010001
10111110111111111011111110101010101
10100000000000001010000010101010101
10101110111111101010111110101010101
10101010100000101010000010101010101
10101010111110101011111010111010101
10101010000010101000000010000010101
10101011111110101011111010111110101
10101000000010101010000010100000101
10101110111010111011111110111111101
10100010101010000010000000000000001
10111010101010111010111110111111101
10001010101010101010100010100000101
11101010101010101010101110101110101
10001010101010101010101000101000101
10111010101010101010101011101011101
10100010101010001010100010001000101
10101110101011101010111010101110101
10101010101000101010001010101000101
10101010101110101011101110101011101
10101010100010101000100000101000101
10101010101010101010111111101110101
10101010101010101010100000001000101
10101010111010101011111111101011101
10101010001010101010100000001000101
10101011101010101110101111101110111
10101000101010100000101000100010001
10111110101010111111101010111011101
10100000101010000000101010001000101
10101010101010111111101011101110101
10101010101010000000001010000000101
10101010101011111111111011111111101
10101010101000000010001010001000101
10101010101111111011101010101010101
10101010101000000000001010101010101
10101010101011111011111010101010101
10101010101000001000001010101010101
10101010101111111111101010101010101
00101010100000000000101010101010101
10101010111111111110101010101010101
10101010100000000010101010101010101
10101010111110111010101010101010101
10101010000000100010100010101010101
10101011111111111010111110101010101
10001000000000001010000000101010101
11111111111111101011111111101110101
10000000000000001010000000100000101
10111111111111111010111110101111101
10100000100000001010100010100000101
10101111111111101010101110111110101
10100000001000001010101000100010101
10101111101011111010101011111010101
10100000101000001010101000000010101
10101110101111101010101011111110101
10100010100000001010101010000000101
10101110111111111010101010111011101
10100010000000000010101010101010001
10111010111111111110101010101010101
10101010000000000010100010101010101
10101011111111111110101010101010101
10101010000010000000101000101010101
10101010111010111111111111101010101
10101010001010100000000010001010101
10101011101010101111111111101010101
10001000001010100000101000101010101
10111111111010111110101010101010101
10100010001000000000101010100010101
10101010101111111111101010111111101
10101000100000000000000010000000001
11111111111111111111111111111111111
