7 7
1111111
0000001
1111101
1000001
1011111
1000000
1111111