21 21
111111111111101111111
101000000000100000001
101011111110111111101
101000000010000000101
101111111011111011101
100000001000001010001
111111101111101010101
100000101000001000101
101110101011111011111
101000101010001010101
101011101010101010101
101000001010101010001
101111111010101111101
100000000010100000101
111110111110111110101
100010100000000010001
101010101111111011111
101010100000001000101
101010101111101110101
101000001000000010001
101111111111111111111